98,223,98,223,98,223,98,223,28,223,28,223,0,10,0,0,0,0,0,0,86,86,86,86,86,86,86,86,86,22,22,22,22,22,22,22,22,22,22,22,255,54,16,97,16,0,0,0,132,0,48,0,10,1,0,32,0,128,0,16,16,3,16,64,0,0,2,1,0,0,8,0,66,0,32,65,0,24,0,1,64,0,0,0,0,0,255,0,222,63,97,16,144,144,144,144,144,144,177,177,24,20,16,12,8,4,0,3,7,32,110,124,14,56,8,11,0,0,0,255,0,255,0,0,255,0,67,0
98,223,98,223,98,223,98,223,91,223,28,223,0,10,0,0,0,0,0,0,86,86,86,86,86,86,86,86,86,22,22,22,22,22,22,22,22,22,22,22,19,126,19,19,51,128,0,0,132,0,48,0,10,1,0,32,32,128,0,16,16,3,16,64,0,0,2,1,0,0,8,0,66,0,32,65,0,24,0,0,64,0,0,0,0,5,255,0,222,53,63,51,179,179,179,179,179,179,18,179,23,27,31,35,39,43,47,72,70,16,125,124,8,46,7,62,0,0,144,255,0,255,0,28,255,3,67,0
98,223,98,223,98,223,98,223,28,223,35,223,0,10,0,0,0,0,0,0,86,86,86,86,86,86,86,86,86,22,22,22,22,22,22,22,22,22,22,22,14,254,14,14,14,0,0,0,132,0,48,0,10,1,0,32,0,0,0,16,16,3,16,64,0,0,2,1,0,0,8,0,66,0,32,65,0,24,0,1,64,0,0,0,0,60,255,0,222,63,97,14,142,142,142,142,142,142,142,142,109,105,101,97,93,89,85,81,77,32,1,0,11,56,8,255,0,0,1,255,0,255,0,14,167,1,131,0
98,223,98,223,42,223,35,223,91,223,77,223,126,1,0,0,0,0,0,0,86,86,86,86,86,86,86,86,86,22,22,22,22,22,22,22,22,22,22,22,7,134,13,13,45,0,0,0,132,0,48,8,10,1,0,32,0,128,32,16,16,2,16,64,0,0,34,1,0,0,0,0,2,0,4,65,0,24,0,0,64,0,0,0,0,29,255,0,222,63,97,12,173,39,167,167,167,167,167,177,120,123,1,5,9,13,17,24,6,0,125,124,13,56,6,48,0,33,151,255,0,255,0,97,4,1,67,0
98,223,98,223,98,223,42,223,63,223,42,223,254,2,0,0,0,0,0,0,86,86,86,22,86,86,86,86,86,22,22,22,22,22,22,22,86,22,22,22,255,206,0,0,0,0,0,0,132,0,48,0,10,1,0,32,0,128,0,16,16,2,16,64,0,0,2,1,0,0,1,32,2,0,32,1,0,24,0,1,64,0,0,0,0,0,255,102,222,53,63,4,33,161,161,161,163,163,163,167,0,55,59,63,67,45,33,12,15,32,1,0,0,46,4,255,0,2,82,255,0,255,0,32,255,1,131,0
98,223,98,223,35,223,77,223,77,223,42,223,48,7,0,0,0,0,0,0,22,22,22,22,22,22,86,86,86,22,22,22,22,22,22,22,22,22,22,22,255,182,16,97,16,0,0,0,132,0,48,128,10,1,0,32,0,128,0,16,16,2,16,64,0,0,34,1,0,0,32,0,2,0,32,1,0,24,0,1,64,0,0,0,0,0,255,0,222,63,97,16,16,144,144,144,144,14,47,47,40,32,28,24,20,16,67,59,73,1,1,0,12,56,6,160,0,23,114,255,127,255,0,31,230,3,131,0
98,223,98,223,98,223,91,223,28,223,77,223,124,9,0,0,0,0,0,0,86,86,86,86,86,86,86,86,86,22,22,22,22,22,22,22,22,22,22,22,255,30,19,19,51,32,0,0,132,0,48,0,10,1,0,48,32,128,0,16,16,2,16,64,0,0,2,1,0,0,8,0,2,0,0,35,0,16,0,0,65,0,0,0,0,4,255,0,222,53,63,51,179,179,179,49,177,177,146,179,19,23,27,31,49,53,57,60,70,16,125,124,16,46,7,54,0,9,7,255,0,255,0,20,255,3,67,0
98,223,98,223,98,223,98,223,35,223,28,223,0,10,0,0,0,0,0,0,86,86,86,86,86,86,86,86,86,22,22,22,22,22,22,22,22,22,22,22,12,38,12,97,45,2,0,0,132,0,48,0,10,1,0,32,0,128,0,16,16,3,16,64,0,0,2,1,0,0,8,0,66,0,32,64,0,16,0,1,64,0,0,0,0,0,255,0,222,63,97,45,12,140,140,140,140,140,140,179,105,94,90,86,82,78,74,70,70,32,1,0,0,56,7,15,0,0,16,255,0,255,0,49,164,3,0,0
98,223,98,223,98,223,35,223,42,223,28,223,126,1,0,0,0,0,0,0,86,86,86,86,86,86,86,86,86,22,22,22,22,22,22,54,22,22,22,22,255,62,0,0,4,0,0,36,132,0,48,0,10,1,0,32,0,128,32,16,16,3,16,64,0,0,2,1,0,0,8,0,66,0,32,64,0,24,0,0,64,0,0,0,0,0,255,102,222,53,63,4,132,132,132,37,2,142,177,179,30,26,22,18,5,56,122,3,10,32,125,31,0,46,5,7,0,1,32,255,0,255,0,0,225,1,131,0
98,223,98,223,98,223,42,223,63,223,70,223,254,2,0,0,0,0,0,0,22,86,86,86,86,86,86,86,86,22,22,22,22,22,22,22,86,22,22,22,16,6,0,97,0,0,0,0,132,0,48,0,10,1,0,32,0,128,0,16,16,3,16,64,0,0,2,1,0,0,8,0,66,0,32,65,0,24,0,1,64,0,0,0,0,0,255,102,222,63,97,16,144,144,144,144,144,144,144,144,50,46,42,38,34,99,50,29,29,16,1,18,0,56,8,25,0,2,86,255,0,255,0,32,255,3,131,0
98,223,98,223,98,223,98,223,28,223,28,223,0,10,0,0,0,0,0,0,86,86,86,86,86,86,86,86,86,22,22,22,22,22,22,22,22,22,22,22,19,150,18,97,18,0,0,0,132,0,48,0,10,1,0,32,0,128,0,16,16,3,16,64,0,0,2,1,0,0,8,0,66,0,32,65,0,24,0,1,64,0,0,0,0,0,255,0,222,63,97,18,146,179,179,179,179,179,179,179,6,2,1,5,9,13,17,21,25,32,125,124,11,56,8,27,0,0,0,255,0,255,0,0,255,0,67,0
98,223,98,223,35,223,49,223,63,223,28,223,252,3,0,0,0,0,0,0,86,86,86,86,86,86,86,86,86,22,22,22,22,22,22,22,22,22,22,22,18,110,18,18,18,0,0,0,132,0,48,16,10,1,0,32,0,128,0,16,16,3,16,64,0,0,2,1,0,0,8,0,2,0,32,65,0,24,0,1,64,0,0,0,0,44,255,0,222,63,97,18,146,146,146,146,146,146,146,146,45,41,37,33,29,25,21,17,13,0,125,124,5,56,8,15,0,19,80,255,0,255,0,120,70,112,67,0
98,223,98,223,35,223,49,223,28,223,77,223,252,3,0,0,0,0,0,0,86,86,86,86,86,86,86,86,86,22,22,22,22,22,22,22,22,22,22,22,255,174,18,18,18,8,0,0,132,0,48,16,10,1,0,32,0,128,0,16,16,2,16,64,4,0,34,1,0,0,40,0,0,2,0,64,0,16,0,1,64,0,0,0,0,38,255,0,222,53,63,18,146,49,177,177,177,177,177,179,21,17,16,20,24,28,32,36,68,16,92,28,0,46,7,143,0,19,7,255,0,255,0,30,255,3,131,0
98,223,98,223,42,223,28,223,84,223,63,223,56,0,0,0,0,0,0,0,86,86,86,86,86,86,86,86,86,22,22,22,22,22,22,22,22,22,86,22,255,248,19,19,51,8,0,0,132,0,48,0,10,129,0,32,0,128,1,16,16,3,16,64,0,0,2,1,0,64,0,34,2,0,32,64,0,24,0,0,64,0,0,0,0,15,255,0,222,63,97,51,179,179,179,179,179,179,179,179,63,67,71,75,79,83,87,91,95,0,112,60,0,56,8,60,0,32,133,255,0,255,0,19,255,3,131,0
98,223,98,223,98,223,42,223,56,223,28,223,254,2,0,0,0,0,0,0,86,86,86,86,86,86,86,86,86,22,22,22,22,22,22,22,22,22,22,22,255,254,13,10,45,2,0,0,132,0,48,128,10,1,0,32,0,128,32,16,16,3,18,64,0,0,2,1,0,0,0,0,2,0,32,65,0,24,0,1,64,0,0,0,0,60,255,0,222,63,97,45,173,10,43,173,142,142,144,179,68,72,109,114,122,119,110,48,68,32,32,31,19,56,2,52,0,2,64,255,0,255,0,84,5,3,131,0
98,223,98,223,98,223,35,223,42,223,63,223,126,1,0,0,0,0,0,0,86,86,86,22,86,86,86,86,86,22,22,22,22,22,22,22,86,22,22,22,255,6,0,0,0,0,0,0,132,0,48,0,10,1,0,32,0,128,0,16,16,3,16,64,0,0,2,1,0,0,64,10,2,0,32,65,0,24,0,1,64,0,0,0,0,0,255,102,222,53,63,37,165,4,165,37,165,165,165,167,3,7,0,3,11,6,50,32,3,32,1,0,0,46,5,48,0,1,37,255,0,255,0,25,255,1,0,0
98,223,98,223,98,223,56,223,28,223,91,223,12,4,0,0,0,0,0,0,86,86,86,86,86,86,86,86,86,22,22,22,22,22,22,22,22,22,22,22,255,86,6,0,6,0,0,32,132,0,48,0,10,3,0,32,0,0,32,16,16,2,16,64,0,0,2,1,0,0,8,0,2,0,32,64,0,16,0,1,64,0,0,0,0,0,255,0,222,53,63,6,6,134,134,134,167,142,142,175,124,124,120,116,112,115,107,98,66,16,1,0,14,46,5,135,0,4,9,255,0,255,0,59,162,3,0,0
98,223,98,223,98,223,77,223,42,223,35,223,48,7,0,0,0,0,0,0,86,86,86,86,86,86,86,86,86,22,22,22,22,22,22,22,22,22,22,22,255,78,12,12,12,0,0,0,132,0,48,32,10,1,0,32,4,128,0,16,16,2,16,64,0,0,2,1,0,0,8,0,66,0,32,65,0,24,0,1,64,0,0,0,0,57,255,0,222,53,63,12,140,6,134,134,134,136,177,177,97,93,55,51,47,43,20,14,28,32,29,28,0,46,5,7,0,7,33,255,0,255,0,28,255,0,0,0
98,223,98,223,98,223,35,223,42,223,28,223,126,1,0,0,0,0,0,0,86,86,86,86,86,86,86,86,86,22,22,22,22,22,22,22,22,22,22,22,255,190,18,18,18,0,0,32,132,0,48,32,10,1,0,32,0,128,0,16,16,3,16,64,0,0,2,1,0,0,8,0,66,0,32,65,0,24,0,1,64,0,0,0,0,43,255,0,222,63,97,18,146,146,18,146,49,177,179,179,41,37,33,25,21,0,2,6,21,32,1,0,19,56,5,15,0,1,32,255,0,255,0,0,255,8,0,0
98,223,98,223,98,223,70,223,77,223,56,223,124,6,0,0,0,0,0,0,86,86,86,86,86,86,86,86,86,22,22,22,22,22,22,22,22,22,22,22,255,238,19,97,51,128,0,128,132,0,48,0,10,1,0,32,0,0,0,16,16,2,16,64,0,0,2,1,0,0,40,0,66,0,32,65,0,16,0,0,64,0,0,0,0,0,255,0,222,63,97,51,179,179,18,146,146,146,179,179,32,36,40,79,75,71,67,64,80,0,125,124,19,56,7,52,0,6,116,255,0,255,0,22,255,1,67,0
